1111111111111111111111111111
1222222222222112222222222221
1211112111112112111112111121
1311112111112112111112111131
1211112111112112111112111121
1222222222222222222222222221
1211112112111111112112111121
1211112112111111112112111121
1222222112222112222112222221
1111112111114114111112111111
1111112111114444111112111111
1111112111114444111112111111
1111112111444444441112111111
1111112111411111141112111111
7444442444411111144442444447
1111112111411111141112111111
1111112111444444441112111111
1111112111411111141112111111
1111112111411111141112111111
1111112111411111141112111111
1222222222222112222222222221
1211112111112112111112111121
1211112111112112111112111121
1322112222222442222222112231
1112112112111111112112112111
1112112112111111112112112111
1222222112222112222112222221
1211111111112112111111111121
1211111111112112111111111121
1222222222222222222222222221
1111111111111111111111111111
